NO textures/fence_light.xpm
SO textures/fence_dark.xpm
WE textures/Recinto.xpm
EA textures/recintodark.xpm

F textures/grass.xpm
C textures/sky.xpm

1111111111111111111111111
1000000000000000000000001
1000000000000000000000001
1000000000000000000000001
1000000000000000000000001111111
1000000000000000000000000000001
1000000000000000000000000000001
10000000000000000000P0001111111
1000000000000000000000001
1000000000000000000000001
1000000000000000000000001
1000000000000000000000001
1111111111111111111111111
