NO sprites/fence_light.xpm
SO sprites/fence_dark.xpm
WE sprites/recinto.xpm
EA sprites/recintodark.xpm

F sprites/grass.xpm
C sprites/sky.xpm

111111111111111111111111111111111111
1E000000001070000333000004%%%%%%%001
11111111001200700000000000111110%001
17000000001111111100000002160000%001
12000007009003333000005002160000%051
11911111111111111111111111100000%051
 10005200033100000%%%%%%%%%%%%%%%001
 10000000033121110%00111111111111111
 10005052033111110%%%%%%020202000001
 1111111111111111607111%111111111191
 1%%%%%%%%%%%%%%%%%%%%%%000000000001
 1%000000000000000000000000000000001
 1%111111111110770111111111111111101
 1%%%%%%%000011111251200000000000001
 1111110%111011111201911111111111111
      10%100900000001000000000000001
      15%100506111111111111911111001
      13%111111%%%%%%%%%%%%%12600001
      13%100000%00000000000%16000051
      13%000000%11100003111%11111111
      13%%%%%%%%16000003071%%%%%%%01
      111111111111200000211111111%01
                 1505050111111111%01
                 11111111%%%%%%%%%01
                 8%%%%%%%%0700000031
                 1111111110070005031
                         12600050051
                         11111111111

