NO sprites/fence_light.xpm
SO sprites/fence_dark.xpm
WE sprites/recinto.xpm
EA sprites/recintodark.xpm

F sprites/grass.xpm
C sprites/sky.xpm

111111111111111111111111111111111111
1E000000001270000333300004%%%%%%%731
11111111001200700000000000111110%031
17000000001111111100000002120000%031
12000007009003333000005002160%%%%031
11911111111111111111111111120%000051
 10005200033126000%%%%%%%%%%%%700021
 10000000033121113%00111111111111111
 12005052033111113%%%%%%000000602221
 1111111111111111700111%111111111191
 1%%%%%%%%%%%%%%%%%%%%%%000000000071
 1%050000733333300000000600000000061
 1%111611111110770111111111111111101
 1%%%%%%%006211111251222900500002221
 1111113%111011111201911111111111111
      13%100900700001003300007000001
      15%100506111111111111911111101
      13%111111%%%%%%%%%%%%%12600001
      13%100500%00007000605%16000051
      13%050007%11100003111%11111111
      13%%%%%%%%16005033071%%%%%%%01
      111111111111200000211160611%01
                 1505050111111111%01
                 11111111%%%%%%%%%01
                 8%%%%%%%%0700063331
                 1111111110070005031
                         12600050051
                         11111111111
