NO textures/fence_light.xpm
SO textures/fence_dark.xpm
WE textures/Recinto.xpm
EA textures/recintodark.xpm

F textures/grass.xpm
C textures/sky.xpm

1111111111111111111111111111111111111111111111111111111111111111111111111111
10P0000000000100000000000000E1        10000000100000001000010000000001000001
1111111111100101111110000011111111111110000000101011101010110000000001011101
100000E1000001001   10000010000000000010000010100000101000100000000001010001
1000000000000110111110000000111111111011101010101110101011101111110111110111
101000000000000E100000000000101000000010001010101000101000000000000000000001
1010111110111111111010111011101111111011101010111110101011110111110000000001
1010100010000000000010101000000000000010000010101000101000000100010100000001
1010111011111110111110100000111111101010000010101011101011110101010111111111
1010000010000000000010000000100000001010000010101000001000100000100000000001
1011111010000000000011111010101111101110000010101011111010100000111111110111
1000001010000000000000000010000000000000100000100000100000100000000000000001
1011101111110111111111111110111110000000111011100000111110111111101111111111
1010000000000100000000000000000010000000100000100000100000000000100000000001
1110111111101110000000000111111000000000111110000000100000000000111011110111
1000100000100000100000000100000000000000100000101000001000000000000010000001
1011101111111111111011101011111110111110111010111011111011110111111110111111
1000001000100000000000101000000101000101000000100000000000000000000000100001
1111101110101110111011101110111010101110111110111011111011101111110111010111
1000101000101000000010000000000000101000100000000000000000000000100000000001
1010111110111011111011111111110111110111110111110111111110111111111111111111
1000100000000000000000000000000000000000000000000000000000000000000000000001
1110101111111011110111111111111110111011111010111111110111011110111110111111
1000000000000010000100000000000000000000000000100000001000000010000010000101
1011110111111110111011110111111111111110111111110111011111111010111111110101
1000000000000100000100000000000000000010000000000000000000000000100000000101
1010111111101111111110111111111011111110111110111110111111111110111110111101
1000000100000000000000100000100000000000000000101000000000000100000100000001
1110111111111111111111111111111011111010111110101011111111111110111110111111
1000100000000000000000000000000000000000000000000000000000000000100000000001
1110111111111011111011111111111111111010111111111011111111111110111110111111
1000000100000000000000100000000000000000000000000000000000100000000100000001
1111110111011111111110101111111011111111111011111110111010111111111011111111
1000000101000100000000000000000000000000000000000000000000000000000000000001
1011111111110111111111111111111011111111111111111011111111111111111111110111
1000000000000100000000000000000010000000000000000000000000000000000000000001
1111111111111111111111111111111111111111111111111111111111111111111111111111