NO sprites/fence_light.xpm
SO sprites/fence_dark.xpm
WE sprites/recinto.xpm
EA sprites/recintodark.xpm

F sprites/grass.xpm
C sprites/sky.xpm

111111111111111111111
10N000002020201000001
100000000000009000001
100000000000001111111
100030030000009000008
100000000000001111111
100004000050600703001
100000303030000000001
111111111111111111111
