NO textures/fence_light.xpm
SO textures/fence_dark.xpm
WE textures/recinto.xpm
EA textures/recintodark.xpm

F textures/grass.xpm
C textures/sky.xpm

111111111111111111111
100000000000000000001
1000P0000000000000001
100000000000000000001
100000000000000000001
100S000000C000F000001
100000000000000000001
100000000000000000001
111111111111111111111
