NO sprites/fence_light.xpm
SO sprites/fence_dark.xpm
WE sprites/recinto.xpm
EA sprites/recintodark.xpm

F sprites/grass.xpm
C sprites/sky.xpm

11111111111111111111111111
1E000000000000000000000001
10000000002020200000000001
10000000000000000000000001
10000303030000000000000001
10000000000000000000400001
11111111111111111111111111
