NO sprites/fence_light.xpm
SO sprites/fence_dark.xpm
WE sprites/recinto.xpm
EA sprites/recintodark.xpm

F sprites/grass.xpm
C sprites/sky.xpm

11111111111111111111111111
1E000600090000000000000008
10000000011111111111111111
1000400001
1000111001
10001 1001
11111 1111
