NO textures/fence_light.xpm
SO textures/fence_dark.xpm
WE textures/recinto.xpm
EA textures/recintodark.xpm

F textures/grass.xpm
C textures/sky.xpm

111111111111111111111
100000002020202000001
1000N0000000000000001
100000000000000000001
100030030000000000008
100000000000006000001
100004000057600003001
100000303030000000001
111111111111111111111
